DIM 6 6
TEMPO 10
MON m1.m
XXoXXX
XoooXX
XoXoXX
Xooo@X
XooooX
XXXXXX
